                                                                               
                                             🌷   🌷                             
                     ███████████████████████████████████████████████████       
                     █                                       ██        █       
                     █                                                 █       
                     █                                      ▞██▚📚📚 📖 📚 █       
                     █📖 ╔╤╤╤╤╤╤╤╤╤╤╤╤╤╤╤╕   ╔╤╤╤╤╤╤╤╤╤╤╤╕📖 ▞████████████       
                 🌷 🌷 █████████████████████☰██████████████████▞         █       
                ██████                    ☰                            █       
               ██                         ☰                            █       
             🌷 █                    📖   📚 ☰ 📚    🌷 🌷 📚 📚   📚 📚 📚       █       
            ████                   ███☰███☰███  █████████████████▚ 📖 📖 █       
                                      ☰                          ███████       
           ▞███████▚     🌷            ☰                                        
      ▞███████████████████████████████████████████████████████████████████▚    
███████████████████████████████████████████████████████████████████████████████
