                                                                               
                                                                               
                                                                               
                                                                               
                                                        ███████                
                                                        █     █                
                                                        █     ██               
                                                        █      ███             
                                                        █        █             
                                                        █        █             
                                                        █        █             
                                                        █        █             
                                 ⋇ ⋇ ⋇                  ████☰█████             
      ⋇ ⋇ ⋇                     ▞██████⍾ ⍾██████▚           ☰                  
   ▞████████⍾ ⍾████████▚       ▞█████████████████▚          ☰                  
███████████████████████████████████████████████████████████████████████████████
