                                                                               
                                                                               
                                                                               
                                                         🌷                     
                                                        ███████                
                                                        █     █                
                                                        █     ██               
                                                        █      ███             
                                                        █        █      🌷      
                                                        █        █ ███████     
                                                        █        █ █     █     
                                                        █        █ █     █     
                                 ⋇ ⋇ ⋇        🌷         ████☰█████ █     █     
      ⋇ ⋇ ⋇                     ▞██████⍾ ⍾██████▚       ████☰█████ █████☰█     
   ▞████████⍾ ⍾████████▚   🌲   ▞█████████████████▚  🌳   ▧▧▧▧▧▧▧▧▧▧▧▧▧▧▧▧▧▧     
███████████████████████████████████████████████████████████████████████████████
