                                                                               
                                                                        ⍾   ⍾  
                                                                 ██████████████
                                                                 █     █      █
                                                              ⍾  █     █      █
                                                              █  🚪     🚪      █
                                                              █████☰███████████
                                                              █    ☰          █
                                                         ⍾    █    ☰   █      █
                                                        ██▚   🚪    ☰   🚪      █
                                                        ███████████████████☰███
               ⍾       ⍾                                █     █            ☰  █
              ███     ███                             ⍾ ▧     █            ☰  █
              ▧ ▧     ▧ ▧      🌲  🌲  🌲               ████▚    🚪            ☰  █
  ▞███████████████████████████████████████▚          ┇1 ███████████████████████
███████████████████████████████████████████████████████████████████████████████
