                                                                               
                                                                               
                                                                               
                                                                               
       ████████████████████████████████████                                    
       █                █                 █                                    
       █                █                 █                                    
       █                █                 █                                    
       █                █       ⍑⍑ ⍑⍑ ⍑1⍑ █                                    
       █                █    ▞█████████████                                    
                        ▐   ▞                                                  
       █2⍑⍑   ⌸ ⍑⍑ ⍑ ⌸⌸ 🚪  ▞              █                                    
       █████☰██████████████████████████████                                    
       █████☰██████████████████████████████                                    
       ▧▧▧▧▧▧▧▧▧▧▧▧▧▧▧▧▧▧▧▧▧▧▧▧▧▧▧▧▧▧▧▧▧▧▧▧                                    
███████████████████████████████████████████████████████████████████████████████
