                                                                               |
                                                                               |
                                                                               |
                                                                               |
       ████████████████████████████████████████████████████████████████        |
       █                █                 █                           █        |
       █                █                 █                           █        |
       █                █                 █                           █        |
                        ▐                 ▐                                    |
       █        c       d        c        d         s    s      c    █        |
       █████☰██████████████████████████████████████████████████████████        |
            ☰                                                                  |
            ☰                                                                  |
            ☰                                                                  |
   g  g  s  ☰    s s                                                           |
███████████████████████████████████████████████████████████████████████████████|
