                                                                               
                                                                               
                                                                               
                                                                               
       █⧚██████████████████████████████████████████████████████████████        
       █⧚               █                 █                           █        
       █⧚               █                 █              📚  📚         █        
       █⧚               █                 █          ██████████████████        
        ⧚               ▐                 ▐                                    
       █⩟   1   ⌸       🚪      📚 ⌸ 📖      🚪                           █        
       █████☰███████████████████████████████████████▚  ◪◧ ◨◧◧◩  ◧◧ ◩◧◨█        
       █    ☰                                       ▚██████████████████        
       █  🌷 ☰ 🌷  ⌸ ⌸                      ⍑ ⍑ 🌷                   █            
       █████☰██████████████████████████████████████████████████████   █        
       ▧▧▧▧▧▧▧▧▧▧▧▧▧▧▧▧▧▧ ▧▧▧ ⌸ ▧▧▧▧▧ ▧▧▧▧ ▧▧▧▧▧▧ ▧▧▧▧▧▧▧▧▧ ▧▧▧▧▧▧▧  ███2      
██████████████████████████████████████████████████████████████████████████⏖⏖⏖⏖⏖
