                                                                               
                                                                               
                                                                               
                                                                               
       █⧚██████████████████████████████████████████████████████████████        
       █⧚               █                 █                           █        
       █⧚               █                 █                           █        
       █⧚               █                 █          ██████████████████        
        ⧚               ▐                 ▐                                    
       █⩟       ⌸       🚪        ⌸        🚪                           █        
       █████☰███████████████████████████████████████▚  ◩◩ ◨◪◪◨  ◧◩ ◨◪◨█        
            ☰                                       ▚██████████████████        
            ☰                                                                  
            ☰                                                         █        
            ☰                 ⌸                                      ███       
██████████████████████████████████████████████████████████████████████████⏖⏖⏖⏖⏖
