                                                                               |
                                                                               |
                                                                               |
                                                                               |
       █⧚██████████████████████████████████████████████████████████████        |
       █⧚               █                 █                           █        |
       █⧚               █                 █                           █        |
       █⧚               █                 █          ██████████████████        |
        ⧚               ▐                 ▐                                    |
       █⩟       ⌸       🚪        ⌸        🚪                           █      |
       █████☰███████████████████████████████████████▚  ◩◩ ◨◪◪◨  ◧◩ ◨◪◨█        |
            ☰                                       ▚██████████████████        |
            ☰                                                                  |
            ☰                                                         █        |
            ☰                 ⌸                                      ███       |
██████████████████████████████████████████████████████████████████████████⏖⏖⏖⏖⏖|
