                                                                               
                                                                               
                                                                               
                                                                               
       █⧚██████████████████████████████████████████████████████████████        
       █⧚               █                 █                           █        
       █⧚               █                 █                           █        
       █⧚               █                 █          ██████████████████        
        ⧚               ▐                 ▐                                    
       █⩟   1   ⌸       🚪        ⌸        🚪                           █        
       █████☰███████████████████████████████████████▚  ◪◪ ◧◧◨◨  ◪◨ ◪◨◪█        
            ☰                                       ▚██████████████████        
            ☰                                                                  
            ☰                                                         █        
            ☰                 ⌸                                      ███2      
██████████████████████████████████████████████████████████████████████████⏖⏖⏖⏖⏖
