                                                                               
                                                                               
                                                                               
                                                                               
       █⧚██████████████████████████████████████████████████████████████        
       █⧚               █                 █                           █        
       █⧚               █                 █                           █        
       █⧚               █                 █          ██████████████████        
        ⧚               ▐                 ▐                                    
       █⩟       ⌸       🚪        ⌸        🚪                           █        
       █████☰███████████████████████████████████████▚  ◨◨ ◩◨◧◩  ◨◩ ◨◩◩█        
            ☰                                       ▚██████████████████        
            ☰                                                                  
            ☰                                                         █        
            ☰                 ⌸                                      ███       
███████████████████████████████████████████████████████████████████████████████
