                                                                               
                                                                               
                                                                               
                                                                               
       █⧚██████████████████████████████████████████████████████████████        
       █⧚               █                 █                           █        
       █⧚               █                 █                           █        
       █⧚               █                 █          ██████████████████        
        ⧚               ▐                 ▐                                    
       █⩟   1   ⌸       🚪        ⌸        🚪                           █        
       █████☰███████████████████████████████████████▚  ◨◧ ◨◪◧◧  ◪◩ ◧◩◧█        
            ☰                                       ▚██████████████████        
            ☰                                                                  
            ☰                                                         █        
            ☰                 ⌸                                      ███       
██████████████████████████████████████████████████████████████████████████⏖⏖⏖⏖⏖
