                                                                               
                                                                               
                                                                               
                                                                █              
                                                               ╱ ╲             
                                                 ╱╲           ╱   ╲            
                                                ╱  ╲         ╱     ╲           
                                               ╱    ╲        ███████           
                                               ██████        █     █           
                                               █    █        █     █           
                                               █    █        █                 
                                               █    █        █ 2   █           
                                               ██☰███        ████☰██           
                                               ▧▧▧▧▧▧        ▧▧▧▧▧▧▧           
           9  █     █     █              ▞███████████████☰█████████████████████
⏖⏖⏖⏖⏖⏖⏖⏖1████████████████████████████████████████████████☰█████████████████████
