             ▞▚                                                                
  ▞▚        ▞  ▚    ████████                                       ██████      
 ▞  ▚      ▞    ▚   █      █                                       █    █      
▞    ▚     █    █   █      █                                       █    █      
██████     █    █   █      █                        ▞▚             ███☰██      
█    █     ██☰███   ██☰█████                       ▞  ▚            ▧▧▧▧▧▧      
█    🚪     ▧▧▧▧▧▧   ▧▧▧▧▧▧▧▧                      ▞    ▚        ███████████████
████████████████████████████████☰     ▞▚         ▞      ▚                      
                                 ▭▭▭ ▞  ▚▞▚              ▚     ▞▚              
 ▞▚▚  ▞▚      ▞▚            ▞▚      ████████▭▭▭▭████████☰█    ▞  ▚             
 ████████████████          ▞  ▚     █      █    █       ☰█   ▞    ▚            
 █              █         ▞    ▚    █           █       ☰█   ██████            
 █              █         █    █    █      █    █        █   █    █            
 █████████████☰██         █☰████    █████☰██    ████☰█████   ██☰███            
 ▧▧▧▧▧▧▧▧▧▧▧▧▧▧▧▧         ▧▧▧▧▧▧    ▧▧▧▧▧▧▧▧    ▧▧▧▧▧▧▧▧▧▧ 1 ▧▧▧▧▧▧  🐘         
████████████████████☰██████████████████████████████████████████████████████████
