                          ╱╲            ╱╲                                     
                         ╱  ╲          ╱  ╲                                    
                        ╱    ╲        ╱    ╲                                   
                       ╱      ╲      ╱      ╲                                  
                      ╱        ╲    ╱        ╲                                 
                     ╱          ╲  ╱          ╲                                
                    ╱            ╲╱            ╲ 🌷                             
                    ███████████████████████████████                            
                    █                             █                            
                    █                             █                            
                    █                             █                            
                    █                             █                            
                    █ ⌸                         ⌸ █                            
                    ███████☰██████████████☰████████                            
  ⍾     8 9         ▧▧▧▧▧▧▧▧▧▧▧▧▧▧▧▧▧▧▧▧▧▧▧▧▧▧▧▧▧▧▧                            
███████████████████████████████████████████████████████████████████████████████
