                                                                               
                              ☰█         █                                     
                              ☰█☰█████████                                     
                              ☰█☰      ▭ █                                     
                              ☰█☰    ▭   █                                     
                              ☰█☰☰     ▭ █                                     
                              ☰█  ▭      █                                     
                              ☰█   ☰    ▭█                                     
                              ☰█ ▭ ☰  ▭  █                                     
                              ☰█   ▭ ▭   █                                     
                              ☰█    ▭ ☰  █                                     
                              ☰█▭      1 █                                     
                              ☰█      █▭ █                                     
                              ☰████████  █                                     
                              ☰████████  █                                     
███████████████████████████████████████████████████████████████████████████████
