                                         ☰☰                                    
                               █         █☰                                    
                               ███████████☰                                    
                               █         █☰                                    
                               █     ▭   █☰                                    
                               █       ▭ █☰                                    
                               █  ▭      █☰                                    
                               █         █☰                                    
                               █      ▭  █☰                                    
                               █   ▭     █☰                                    
                               █    ▭    █☰                                    
                               █▭      1 █☰                                    
                               █      █▭ █☰                                    
                               ████████  █☰                                    
                               ████████  █☰                                    
███████████████████████████████████████████████████████████████████████████████
