                                         ☰☰                                    
                               █         █☰                                    
                               █☰█████████☰                                    
                               █☰      ▭ █☰                                    
                               █☰    ▭   █☰                                    
                               █☰☰     ▭ █☰                                    
                               █  ▭      █☰                                    
                               █   ☰    ▭█☰                                    
                               █ ▭ ☰  ▭  █☰                                    
                               █   ▭ ▭   █☰                                    
                               █    ▭ ☰  █☰                                    
                               █▭      1 █☰                                    
                               █      █▭ █☰                                    
                               ████████  █☰                                    
                               ████████  █☰                                    
███████████████████████████████████████████████████████████████████████████████
